20
200
9 2 9 2 18 18 18 18 18 18 18 2 9 2 9 18 18 18 9 2 
9 2 9 2 18 18 18 18 18 18 18 2 9 2 9 18 18 18 22 22 
9 2 9 2 18 18 18 19 18 18 18 2 9 2 9 18 18 18 22 22 
9 2 9 2 18 18 18 19 18 18 18 2 9 2 9 18 18 18 22 22 
9 2 9 2 18 18 18 19 18 18 18 2 9 2 9 18 18 18 22 22 
9 2 9 2 18 18 18 19 18 18 18 2 9 2 9 18 18 18 9 2 
9 2 9 2 18 18 18 18 18 18 18 2 9 2 9 18 18 18 22 22 
9 2 9 2 18 18 18 18 18 18 18 2 9 2 9 18 18 18 22 22 
9 2 9 2 18 18 18 19 18 18 18 2 9 2 9 18 18 18 22 22 
9 2 9 2 18 18 18 19 18 18 18 2 9 2 9 18 18 18 22 22 
9 2 9 2 18 18 18 19 18 18 18 2 9 2 9 18 18 18 9 2 
9 2 9 2 18 18 18 19 18 18 18 2 9 2 9 18 18 18 22 22 
9 2 9 2 18 18 18 18 18 18 18 2 9 2 9 18 18 18 22 22 
9 2 9 2 18 18 18 18 18 18 18 2 9 2 9 18 18 18 22 22 
9 2 9 2 18 18 18 19 18 18 18 2 9 2 9 18 18 18 22 22 
9 2 9 2 18 18 18 19 18 18 18 2 9 2 9 18 18 18 9 2 
9 2 9 2 18 18 18 19 18 18 18 2 9 2 9 18 18 18 22 22 
9 2 9 2 18 18 18 19 18 18 18 2 9 2 9 18 18 18 22 22 
9 2 9 2 18 18 18 18 18 18 18 2 9 2 9 18 18 18 22 22 
9 2 9 2 18 18 18 18 18 18 18 2 9 2 9 18 18 18 22 22 
9 2 9 2 18 18 18 19 18 18 18 2 9 2 9 18 18 18 9 2 
9 2 9 2 18 18 18 19 18 18 18 18 18 18 18 18 18 18 9 2 
9 2 9 2 18 18 18 19 18 18 18 18 18 18 18 18 18 18 9 2 
9 2 9 2 18 18 18 19 18 18 18 18 18 18 18 18 18 18 9 2 
9 2 9 2 18 18 18 18 18 18 18 2 9 2 9 2 9 2 9 2 
9 2 9 2 18 18 18 18 18 18 18 2 9 2 9 2 9 2 9 2 
9 2 9 2 20 20 20 20 20 20 20 2 9 2 9 2 9 2 9 2 
9 2 9 2 20 20 20 20 20 20 20 2 9 2 9 2 9 2 9 2 
9 2 9 2 22 22 22 22 22 22 22 2 9 2 9 2 9 2 9 2 
9 2 9 2 22 22 22 22 22 22 22 2 9 2 9 2 9 2 9 2 
9 2 9 2 9 2 9 2 9 2 9 2 9 2 9 2 9 2 9 2 
13 14 13 14 13 14 13 14 13 14 13 14 13 14 13 14 13 14 13 14 
13 14 13 14 13 14 13 14 13 14 13 14 13 14 13 14 13 14 13 14 
13 14 13 14 13 14 13 14 13 14 13 14 13 22 16 22 16 22 13 14 
13 14 13 14 13 14 13 14 13 14 13 14 13 22 16 22 16 22 13 14 
13 14 13 14 13 14 13 14 13 14 13 14 13 22 16 22 16 22 13 14 
13 14 13 14 13 14 13 14 13 14 13 14 13 14 13 14 13 14 13 14 
6 6 13 14 13 14 13 14 13 14 13 14 13 14 13 14 13 14 13 14 
12 6 6 6 6 6 13 14 13 14 13 14 13 14 13 14 13 14 13 14 
12 12 12 12 12 6 6 6 6 6 13 14 13 14 13 14 13 14 13 14 
24 24 12 12 12 12 12 12 12 6 6 6 6 14 13 14 13 14 13 14 
24 24 24 24 24 24 24 24 12 12 12 12 6 6 13 14 13 14 13 14 
25 25 25 25 25 25 25 24 24 24 24 12 12 6 13 14 13 14 13 14 
25 25 25 25 25 25 25 25 25 25 24 24 12 6 6 14 13 14 13 14 
25 25 25 25 25 25 25 25 25 25 24 24 12 12 6 6 6 6 13 14 
26 26 26 26 26 26 25 25 25 25 25 24 24 12 12 12 12 6 6 6 
26 26 26 26 26 26 26 26 25 25 25 25 24 24 12 12 12 12 12 12 
27 27 27 27 27 26 26 26 25 25 25 25 24 24 24 24 24 24 12 12 
26 26 26 26 27 27 26 26 26 25 25 25 24 24 24 24 24 24 24 24 
26 26 26 26 26 27 27 27 26 26 25 25 25 25 25 25 25 25 24 24 
25 25 25 25 26 26 26 29 29 26 26 25 25 25 25 25 25 25 25 24 
25 25 25 25 25 26 28 29 29 29 28 28 25 25 25 25 25 25 25 25 
25 25 25 25 25 26 28 29 29 29 29 28 28 26 25 25 25 25 25 25 
24 24 24 24 25 26 28 28 28 28 29 29 28 26 26 26 26 26 26 25 
6 6 6 24 24 25 26 28 28 28 28 28 28 27 26 26 26 26 26 26 
10 10 6 6 24 24 25 27 27 27 27 26 26 27 27 26 26 26 26 26 
10 10 10 6 6 24 25 25 25 25 27 27 27 26 27 27 27 27 26 26 
10 10 10 10 6 6 24 24 25 25 25 25 26 26 26 26 27 27 27 27 
3 10 10 10 10 6 6 24 24 25 25 25 25 26 26 26 26 26 27 27 
4 3 10 10 10 10 6 6 24 24 25 25 25 26 26 26 26 26 26 26 
3 4 3 10 10 10 10 6 6 24 25 25 25 25 25 25 25 25 25 25 
4 3 4 3 10 10 10 10 6 24 24 25 25 25 25 25 25 25 25 25 
3 4 3 4 3 10 10 10 6 6 24 24 25 25 25 25 25 25 25 25 
4 3 4 3 4 3 10 10 10 6 6 24 24 25 25 25 24 24 24 24 
3 4 3 4 3 4 10 10 10 10 6 6 24 24 25 24 24 6 6 6 
4 3 4 3 4 3 4 10 10 10 10 6 6 24 24 24 6 6 10 10 
3 4 3 4 3 4 3 10 10 10 10 10 6 24 6 6 6 10 10 10 
4 3 4 3 4 3 4 3 10 10 10 10 6 6 6 10 10 10 10 10 
3 4 3 4 3 4 3 4 3 10 10 10 10 6 10 10 10 10 10 10 
4 3 4 3 4 3 4 3 4 3 10 10 10 10 10 10 10 10 10 10 
3 4 3 4 3 4 3 4 3 4 10 10 10 10 10 10 10 10 10 4 
4 3 4 3 4 3 4 3 4 3 10 10 10 10 10 10 10 3 4 3 
3 4 3 4 3 4 3 4 3 4 10 10 10 10 10 10 3 4 3 4 
4 3 4 3 4 3 4 3 4 3 10 10 10 10 10 10 4 3 4 3 
3 4 3 4 3 4 3 4 3 10 10 10 10 10 10 4 3 4 3 4 
4 3 4 3 4 3 4 3 10 10 10 10 10 10 4 3 4 3 4 3 
3 4 3 4 3 4 3 4 10 10 10 10 10 4 3 4 3 4 3 4 
4 3 4 3 4 3 4 3 10 10 10 10 10 3 4 3 4 3 4 3 
6 6 6 6 6 6 6 6 10 10 10 10 10 6 6 6 6 6 6 6 
6 6 6 6 6 6 6 6 10 10 10 10 10 6 6 6 6 6 6 6 
18 18 18 18 18 18 18 18 18 18 18 18 18 18 18 18 18 18 18 18 
18 18 18 18 18 18 18 18 17 18 18 18 17 18 18 18 18 18 18 18 
18 18 18 18 18 18 18 18 18 18 18 18 18 18 18 16 16 16 16 16 
18 18 18 18 18 18 18 18 17 18 18 18 17 18 18 16 16 16 16 16 
18 18 18 18 18 18 18 18 18 18 18 18 18 18 18 16 16 16 16 16 
20 20 18 18 18 18 18 18 17 18 18 18 17 18 18 16 16 16 16 16 
20 20 20 18 18 18 18 18 18 18 18 18 18 18 18 18 18 18 18 18 
20 20 20 18 18 18 18 18 18 18 18 18 18 18 18 18 18 18 18 18 
20 20 20 20 18 22 18 22 18 22 18 18 18 18 18 18 18 18 18 18 
20 20 20 20 18 22 18 22 18 22 18 18 17 17 17 18 17 17 17 18 
20 20 20 20 18 22 18 22 18 22 18 18 18 18 18 18 18 18 18 18 
20 20 20 20 18 18 18 18 18 18 18 18 17 17 17 18 16 16 16 18 
20 20 20 18 18 21 18 23 18 23 18 18 18 18 18 18 18 18 18 18 
20 20 20 18 18 21 18 23 18 23 18 18 17 17 17 18 17 17 17 18 
18 18 18 18 18 21 18 23 18 23 18 18 18 18 18 18 18 18 18 18 
6 6 6 6 18 18 18 18 18 18 18 18 9 9 9 18 17 17 17 18 
26 26 26 6 6 6 18 18 18 18 18 18 18 18 18 18 18 18 18 18 
26 26 26 26 26 6 6 6 6 6 6 6 18 18 18 18 18 18 18 18 
6 6 26 26 26 26 26 26 26 26 26 6 6 18 18 18 18 18 18 18 
18 6 6 6 26 26 26 26 26 26 26 26 6 18 18 18 18 18 18 18 
18 18 18 6 6 6 6 26 26 26 26 26 6 18 6 6 6 6 6 6 
18 18 18 18 18 18 6 6 6 6 6 6 6 18 6 26 26 26 26 6 
18 18 18 18 18 17 17 17 18 21 21 21 6 18 6 26 26 26 26 26 
18 18 18 18 18 17 17 17 18 21 21 21 6 18 6 6 26 26 26 26 
23 23 23 18 18 17 17 17 18 21 21 21 6 18 18 6 6 6 26 26 
23 23 23 18 18 17 17 17 18 21 21 21 6 18 18 18 18 6 6 6 
23 23 23 18 18 17 17 17 18 21 21 21 6 18 18 18 18 18 18 18 
23 23 23 18 18 18 18 18 18 18 18 18 6 18 18 22 22 22 22 18 
23 23 23 18 18 21 21 21 18 17 17 17 6 18 23 22 22 22 22 18 
23 23 23 18 18 21 21 21 18 17 17 17 6 18 23 22 22 22 22 18 
23 23 23 18 18 21 21 21 18 17 17 17 6 18 23 22 22 22 22 18 
23 23 23 18 18 21 21 21 18 17 17 17 6 18 18 22 22 22 22 18 
23 23 23 18 18 18 18 18 18 18 18 18 6 18 18 18 18 18 18 18 
23 23 23 18 18 18 18 21 21 21 21 21 6 18 18 18 18 18 18 19 
23 23 23 18 18 18 18 21 21 21 21 21 6 18 18 19 19 19 19 19 
23 23 23 18 18 18 18 21 21 21 21 21 6 18 19 19 19 24 24 24 
23 23 23 18 18 18 18 18 18 18 6 6 6 19 19 24 24 24 24 24 
18 18 18 18 18 18 18 18 19 19 6 6 6 19 24 24 24 24 25 25 
18 18 18 18 18 18 19 19 19 19 6 6 6 19 24 24 24 25 25 25 
18 18 19 19 19 19 19 24 24 19 6 6 6 19 24 25 25 25 25 24 
18 19 19 19 24 24 24 24 24 19 6 6 6 19 25 25 25 24 24 24 
19 19 24 24 24 24 24 24 24 19 6 6 6 19 24 24 24 19 19 19 
24 24 24 24 24 24 25 25 25 19 6 6 6 19 19 19 19 19 6 6 
24 24 24 25 25 25 25 24 24 19 6 6 6 6 6 6 6 6 6 6 
24 24 25 25 24 24 24 19 19 19 6 6 6 6 4 4 4 4 4 4 
25 25 24 24 24 6 6 6 6 6 6 6 6 6 4 4 4 4 4 4 
24 24 19 19 19 6 24 2 2 2 2 2 2 6 4 4 4 4 4 4 
19 19 19 19 19 6 24 2 2 2 2 2 2 6 4 4 4 4 4 4 
6 6 6 6 6 6 24 2 2 2 2 2 2 6 4 4 4 4 4 4 
5 5 5 5 5 5 24 2 2 2 2 2 2 6 4 4 4 4 4 4 
5 5 5 5 5 5 24 2 2 2 2 2 2 6 4 4 4 4 4 4 
5 5 5 5 5 5 24 2 2 2 2 2 2 6 4 4 4 4 4 4 
5 5 5 5 5 5 24 2 2 2 2 2 2 6 4 4 4 4 4 4 
5 5 5 5 5 5 24 6 6 6 6 6 6 6 6 6 6 6 6 6 
5 5 5 5 5 5 24 7 7 7 7 7 7 7 7 6 9 9 9 9 
5 5 5 5 5 5 24 7 7 7 7 7 7 7 7 6 9 9 9 9 
5 5 5 5 5 5 24 7 7 7 7 7 7 7 7 6 9 9 9 9 
6 6 6 6 6 6 24 24 24 24 24 24 24 6 6 6 9 9 9 9 
4 5 5 2 4 4 4 2 25 26 26 26 25 4 5 6 9 9 9 9 
4 4 2 5 2 2 4 2 25 26 26 26 25 5 4 6 6 6 6 6 
4 5 5 5 2 4 5 25 25 25 25 25 25 3 3 4 4 3 4 4 
4 5 5 4 4 25 25 25 3 3 3 3 4 3 1 4 4 4 5 4 
4 5 5 5 25 25 3 3 3 7 5 5 5 4 5 4 4 5 5 4 
4 3 25 25 25 4 4 4 5 5 5 4 4 4 5 4 4 4 4 4 
3 25 25 7 4 5 8 4 5 5 4 4 4 4 4 3 3 3 4 4 
7 25 4 4 4 5 5 3 3 3 3 3 3 4 4 3 4 4 8 4 
25 25 4 3 3 3 5 3 3 5 8 8 3 4 8 4 4 4 3 4 
4 4 3 3 4 2 2 2 2 2 2 4 3 5 4 3 4 2 2 3 
2 2 2 3 2 4 4 2 8 5 4 4 4 2 2 4 4 4 2 2 
2 8 5 3 2 2 3 2 4 4 2 2 4 4 2 2 1 2 1 1 
4 4 4 2 2 3 3 2 3 2 2 2 2 1 1 1 1 1 1 1 
3 8 2 2 3 8 4 2 4 1 1 1 1 1 13 13 13 13 13 13 
4 3 4 2 4 4 1 1 3 1 1 1 13 13 13 13 13 13 13 13 
2 2 2 4 1 3 1 1 1 13 13 13 13 13 13 13 12 12 12 12 
4 2 2 4 1 1 13 13 13 13 13 13 13 13 12 12 12 12 30 30 
1 1 3 1 1 1 13 13 13 1 12 12 12 12 12 12 30 30 30 30 
13 13 13 13 13 13 13 13 12 12 12 30 30 30 30 30 30 30 30 30 
13 13 13 13 13 13 13 12 12 30 30 30 31 31 31 31 31 31 31 31 
12 12 12 13 12 12 12 12 12 30 30 31 31 31 31 31 31 31 31 31 
30 30 12 12 12 30 30 30 30 30 31 31 31 31 31 31 31 31 31 31 
31 30 30 30 30 30 30 31 31 31 31 31 31 31 31 31 31 31 31 31 
31 31 31 30 30 30 31 31 31 31 30 30 30 30 30 30 30 30 30 30 
31 31 31 30 31 31 31 31 31 30 30 13 13 13 13 13 13 13 13 30 
31 31 31 31 31 31 31 31 31 30 13 13 14 14 14 14 14 13 13 13 
33 33 33 33 33 31 31 31 30 30 13 13 14 14 14 14 14 14 14 14 
35 34 34 33 33 33 31 31 30 13 13 14 14 2 2 2 2 2 2 2 
35 35 35 34 34 33 33 31 30 13 14 14 14 2 2 2 2 2 2 2 
35 35 35 34 34 33 33 31 30 13 13 14 14 14 14 14 14 14 14 2 
33 34 34 33 33 33 31 31 31 30 13 13 13 13 13 13 13 13 14 14 
33 33 33 33 31 31 31 31 31 30 30 30 30 30 30 13 13 13 13 14 
33 33 33 31 31 31 31 31 33 31 31 31 31 33 30 30 30 30 30 13 
33 33 33 33 31 31 33 33 33 33 33 33 33 33 33 33 33 33 33 30 
33 33 33 31 31 33 33 33 33 33 33 32 32 32 32 32 32 32 32 32 
33 33 33 33 33 33 33 33 33 33 32 32 32 25 31 31 31 25 31 31 
32 33 33 33 33 33 33 33 33 32 32 32 32 30 30 30 24 24 30 30 
32 25 32 32 32 32 32 32 31 31 31 31 24 30 12 12 12 12 12 12 
25 31 25 31 31 25 31 31 25 30 24 30 30 13 12 12 13 13 12 12 
30 24 30 30 30 24 30 30 30 24 12 12 12 13 13 14 14 13 13 13 
12 12 12 12 12 12 12 12 12 12 13 13 13 14 14 14 14 14 14 14 
13 13 13 13 13 13 13 13 13 13 14 14 14 14 14 3 3 5 1 1 
14 14 14 14 14 13 14 14 14 14 14 14 1 1 1 3 1 3 2 1 
14 14 14 14 14 14 14 14 14 1 2 1 2 1 4 4 1 2 1 3 
14 3 1 1 14 14 2 3 1 2 1 1 5 1 1 2 1 1 5 1 
1 1 1 3 3 1 3 1 5 2 2 4 4 4 3 3 4 4 3 1 
1 2 3 5 2 5 5 5 2 2 4 4 4 2 4 4 26 26 5 4 
5 2 2 2 2 1 1 1 1 1 1 1 1 4 3 5 26 27 26 4 
5 3 5 5 2 3 1 3 3 3 3 3 1 3 3 3 4 4 4 4 
5 3 8 8 3 3 3 8 8 3 3 3 3 3 8 5 3 3 3 3 
3 5 5 3 3 3 3 3 3 4 4 3 3 3 5 5 3 4 4 4 
3 3 4 1 1 1 1 1 1 1 1 1 3 3 3 3 8 3 4 3 
3 5 3 1 1 1 1 3 5 8 8 1 1 1 1 8 8 3 3 3 
3 1 5 8 3 3 1 3 5 3 3 4 4 3 1 1 3 4 3 4 
3 4 8 3 1 3 8 3 3 4 3 4 4 4 4 1 8 3 3 3 
4 4 1 5 1 9 9 4 4 1 1 1 1 7 4 4 4 3 5 3 
3 4 1 1 3 8 4 1 4 4 4 3 3 3 1 3 4 3 3 3 
3 1 1 4 3 3 4 1 4 4 3 2 4 3 1 4 3 3 9 3 
4 3 8 5 1 1 4 8 8 1 3 3 3 3 1 3 3 2 3 3 
3 4 4 1 1 4 4 1 4 2 3 9 4 4 4 2 4 3 3 4 
3 1 4 3 4 4 3 1 1 3 2 4 1 1 2 1 1 3 4 4 
3 3 3 4 4 3 3 3 5 2 3 3 3 3 3 3 3 4 4 3 
